*************************************
Maze: 1
File offset: 148C, DS:00FC, table offset: 0000
Size X: 22
Size Y: 11
End: 14BD
Length: 50

    XXXXX
    X   X
    X*  X
  XXX  *XXX
  X  *  * X
XXX X XXX X     XXXXXX
X   X XXX XXXXXXX  ..X
X *  *             ..X
XXXXX XXXX X@XXXX  ..X
    X      XXX  XXXXXX
    XXXXXXXX

*************************************
Maze: 2
File offset: 14BE, DS:012E, table offset: 0032
Size X: 14
Size Y: 10
End: 14E8
Length: 43